#################
#               #
#               #
#               #
#               #
#               #
#        SD     #
#               #
#               #
#               #
#               #
#               #
#################