#######
#  S  #
#  d  #
#     #
#     #
#######