####################
#                  #
#                  #
#                  #
#                  #
#                  #
#    D             #
#    S             #
#                  #
#                  #
#                  #
####################