#######################################
#                                     #
#                                     #
#                                     #
#                                     #
#           SD                        #
#                                     #
#                                     #
#                                     #
                                      #
                                      #
                                      #
#                                     #
#                                     #
#                                     #
#                                     #
#                                     #
#                                     #
#                                     #
#######################################