##################  ####
#           #          #
#           #          #
      #D    #  ##       
      #S    #           
#           #     ##   #
#           #          #
########################
#           #          #
#           #          #
        #   #     #     
            #     #     
#   ##      #          #
#           #          #
##################  ####