####################
#                  #
#                  #
#   S              #
#   D              #
#                  #
#                  #
#                  #
#                  #
####################