####################
#        S         #
#                  #
         D          
                    
                    
                    
#                  #
#                  #
####################