####################
#        S         #
#        D         #
                    
                    
                    
                    
#                  #
#                  #
####################