####################
#                  #
#                  #
#  DS              #
#                  #
#                  #
#                  #
#                  #
#                  #
####################