####################
#                  #
#                  #
#   SD             #
#                  #
#                  #
#                  #
#                  #
#                  #
####################