####################
#                  #
#                  #
#                  #
#                  #
#                  #
#                  #
#                  #
#                  #
################SD  