####################
#                  #
#                  #
#   s              #
#   D              #
#                  #
#                  #
#                  #
#                  #
####################