####################
#                  #
#            ###   #
#   SD             #
#                  #
#                  #
#      #####       #
#                  #
#                  #
####################