####################
#                  #
#   D              #
#   S              #
#                  #
#                  #
#                  #
#                  #
#                  #
####################